l l l l l l l l l l l l l l l
l L L L L L L L L L L L L L l
l L L L L L L L L L L L L L l
l L L L L L L L L L L L L L l
l L L L L L L L L L L L L L l
l L L L L L L L L L L L L L l
l L L L L G L L L L L L L L l
l L L L L L L L L L L L L L l
l L L L L L L L L L L L L L l
l L L L L L L L L L L L L L l
l l l l l l l P l l l l l l l
