w w w w w w w w w w w w w w w
w v v v v z z z z z z z i i w
w z z z z z z z z z z z h h w
w z z z z z z z z z z v v v w
w z z z z z z z z z z z z z w
w z z z z z z z z z s j p z w
w z i i z z z z z z o : k z w
w z h h z z z z z z z z z z w
w z z z z z z z z z z z z z w
w z c e z z z z z z c e z z w
w w w w w w w x w w w w w w w
