w i w i i i i w w i i w i i w
w h z h h h h z z h h z h h w
w z z z z z z z z z z z z z w
w e e z z z z z z z z v v v w
w z z z z z z z z z z z z v w
w z z z v z z z z z s p z z w
w z v v z e e z z z o k z z w
w z z z z z z z z z z z z z w
w z z z z z z z z z z z z z w
w z e e z z z z z z e e z z w
w w w w w w w x w w w w w w w
