S S D G Q S S S S S S S S S S S S S S S S S S S S S S S S
S S D G Q S S S S S S S S S S S S S S S S S S S S S S S S
S S D G W X X X S S S S S S S S S S S S S S X X X S S S S
S S D G G G V B W X X S S X S S S S S S S D $ @ $ Q S S S
S S D G G G G @ O G O Q D O Q S S S S S S D % G % Q S S S
S S D G G G G A Z E @ Q D O W X S S S S S S E G A S S S S
S S S Z Z E G Q S S Z S D F O O Q S S S S S D G Q S S S S
S S X X S D G Q S S S S D O F O Q S S S S X C G Q S S S S
S D F O Q D G Q S S S S S Z Z Z S S S S D G G G Q S S S S
S D O O Q D G Q S S S S S S S S S S S S D G A Z S S S S S
S S Z Z S D G Q S S S S S S S S X S S S D G Q S S X X S S
S S S S S D G Q S S S S S S S C O Q S S D G Q S D O O Q S
S S X X X C G W X X X X X S D O A S S S D G Q S S Z Z S S
S D G G G G G G G G G G G Q S Z S S S X C G W S S S S S S
S D G G G G G G G G G G G W X X X X C G G G G Q S S S S S
S D G G G G G G G G G G G G G G G G G G G G G Q S S S S S
S D G G G G G G G G G G G G G G G G G G G G G Q S S S S S
S D G G G G G G G G G G G G G G G G G G G G G Q S S S S S
S D G G G G G G G G G G G G G A Z Z Z Z E G G Q S S S S S
S D G G G G G G G G G G G A Z S S S S S D G G Q S S S S S
S D G G G G G G G G G G G Q S S S S S S D G G Q S S S S S
S S Z Z Z E G A Z Z Z Z Z S S S S S X X C G G W X X S S S
S S S S S D G Q S S S S S S S S S D G G G G G G G F Q S S
S S S S S D G Q S S S S S S S S S D G G G G G G F G Q S S
S S S S S D G Q S S S S S S S S S D G G G G G G G G Q S S
S S S S S D G Q S S S S S S S S S D G G G G G G G G Q S S
S S S S S D G Q S S S S S S S S S D G G G G G G G G Q S S
S S S S S D G Q S S S S S S S X X C G G G G G A Z Z S S S
S S S S S D G Q S S S S S S D G G G G G G A Z S S S S S S
S S S S S D G W X X X X X X C G G G G G G Q S S S S S S S
S S S S S D G G G G G G G G G G G G G G G Q S S S X S S S
S S S S S D G G G G G G G G G G G G A Z Z S S S D O Q S S
S S S S S S Z Z Z Z Z Z Z Z Z Z Z Z S S S S S S S Z S S S
S S S S S S S S S S S S S S S S S S S S S S S S S S S S S