G G G G G G G G G G G G G G G G G G G G G G G G G G G G G G G G
G G G G G G G G G G G G G G G G G G G G G G G G G G G G G G G G
G G G G G G G G G G G G G G G G G G G G G G G G G G G G G G G G
G G G G G G G G G G G G G G G G G G G G G G G G G G G G G G G G
G G G G G G G G G G G G G G G G G G G G G G G G G G G G G G G G
G G G G G G V B G G G G G G G G G G G G G G G G G G G G G G G G
G G A Z E G G G G G G G G G G G G G G G G G G G G G G G G G G G
G G Q S D G G G G G G G G G G G G G G G G G G G G G G G G G G G
G G W X C G G G G G G G G G G G G G G G G G G V B G G G G G G G
G G G G G G G G G G G G G G G G G G G G G G G G G G G G G G G G
M M . . . . M M M M M M M M M M M M M M M M M M M M M M M M M M
G G . . . . G G G G G G G G G G G G G G G G G G G G G G G G G G
G G . . . . G G G G G G G G G G G G G G G G G G G G G G G G G G
G G G G G G G G G G G G G G G G G G G G G G G G G G G G G G G G
G G G G G G G G G G G G G G G G G M M . . . M M M M M M M M M M
G G G G G G G G G G G G G G G G G M F . . . . . . G F G F O F M
G G G G G G G G G G G G G G G G G M O . . . . . . F G F G F O M
G G G G G G G G G G G G G G G G G M O . . . . . . O F O F G F M
G G G G G G G G G G G G G G G G G M O . . . 1 . . G G G V B G M
G G G G G G G G G G G G G G G G G M M G G R R G G M M M M M M M
G G G G G G G G G G G G G G G G G G G G G R R G G G G G G G G G
G G G R R R R R R R R R R R R R R R R R R R R G G G G G G G G G
G G G R R R R R R R R R R R R R R R R R R R R G G G G G G G G G
G G G R G G G G G G G G G G G G G G G G G G G G G G G G G G G G
G G G R G G G G A Z Z Z E G G G G G G G G G G G G G G G G G G G
G G G R A Z Z Z S S S S D G G G G G G G G G G G G G G G G G G G
Z Z Z R Q S S S S S S S S Z Z Z Z Z Z Z Z Z Z Z Z Z Z Z Z Z Z E
S S S R Q S S S S S S S S S S S S S S S S S S S S S S S S S S D
