S S D R Q S S S S S S S S S S S S S S S S S S S S S S S S
S S D R Q S S S S S S S S S S S S S S S S S S S S S S S S
S S D R Q S S S S S S S S S S S S S S S S S S S S S S S S
S X C R W X S S S S S S S S S S S S S S S S S S S S S S S
C G G R G G W X X X X X X X X X X X X X X X X X X X X X X
G G G R G G G G G G G G G G G G G G G G G G G G G G G G G
G G G R R R R R R R R R R R R R R R R R R G G G G G G G G
G G G R R R R R R R R R R R R R R R R R R G G G G G G O G
G G G G G G G G G G G G G O G G G G G R R G G G G O O O O
G G F G G G G G G G G G G O O G G G G R R G G G G G O G G
G G G G G G G G G G G G G G G G G G G R R G G G G G G G G
G G G G G G G G G G G A Z E G G G G G R R G G G G G G G G
G G O O G G G G G G A S S S E R R R R R R G G O G G G G G
G G G O G G G G G G Q S S S D G G G G R R G O O G G G G G
G G G G G G G G G G W X X X C G G G G R R G G F O O G G G
G G G G G G G G G G O O G G G G G G G R R G G G O G G G G
G G G G G G G G G F G O G G V B G G G R R G G G G G G G G
G G G G G G G G G G G G G G G G G G G R R G G G G G G G G
G G G G G G G O G G G G G G G G G G G R R G G G G G G G G
G G G G G G G F O G G G G G G G G G G R R G G G G G G G G
G G G G G G G G G G G G G G G G G G G R R G G G G G G G G
G G G G G G G G G G G F G G G G G G G R R G G G G G G G G
G G G G G G G G G G G G G G G G G G G R R G G G F G G G G
G G G G G G G G G G G G G G F G G G G R R G G G G G G G G
G G G G G G G G G G G G G G G G G G G R R G G G G G G G G
G G G G G G G G G G G G G G G G G G G R R G G G G G G G G
G G G G G G . . . . . G G G G G O G G R R G G O G G G G G
G G G G G G . . . . . G G G G O O G G R R G G O O O G G G
G G G G G G . . 2 . . G G G G G G G O R R G G O O O G G G
G G G G G G G R R R G F G G G G G O O R R G G G F O G G G
G G G G G G G R R R R R R R R R R R R R R G G G G G G G G
G F G G G G G R R R R R R R R R R R R R R G G G G G G G G
G G F G G G G G G G G G G G G G G G G G G G G G G G G G G
G G G G G G G G G G G G G G G G G G G G G G G G G G G G G
