l l l l l l l l l l l l l l l
l L L L L L L L L L L L L L l
l L L L L L L L L L L L L L l
l L L L L L L L L L L L L L l
l L L L L L L L L L L L L L l
l L L L L L L L L L L L L L l
l L L L L L L L L L L L L L l
l L L L L L L L L L L L L L l
l L L L L L L L L L L L L L l
l L L L L L L L L L L L L L l
l l l l l l l x l l l l l l l
