S S D R Q S S S S S S S S S S S S S S S S S S S S S S S S
S S D R Q S S S S S S S S S S S S S S S S S S S S S S S S
S S D R Q S S S S S S S S S S S S S S S S S S S S S S S S
S X C R W X S S S S S S S S S S S S S S S S S S S S S S S
C G G R G G W X X X X X X X X X X X X X X X X X X X X X X
G G G R G G O O O G G O O G G G O O G G G G G G G O O O G 
G G G R G G G G O G G O G G G O O O G G M M M . . . . M G
G G G R G G G G G G G G G G G G G O G G M F O O O O O M G 
G G G R F G G G G G G G G G G G G G G G M O O . . . . M G
G G G R G G G G G . . . . . G G G G G G G G G G G R G G G 
G G G R G M M M M O O O O O M M G R R R R R R R R R G G G
G G G R G M O O O O O O O O O M G R G G G G G G G G G G G 
G G G R G M O O O O O O O O O M G R G G G G G G G G G G G 
G G G R G M O O O . . . 1 . O M G R G G M M M . . . . M G
G G G R G M O O O O O G R O O M G R G G M F O O O O O M G 
G G G R G M M M M M G G R G G M G R G G M O O . . . . M G
G G G R G G G G G G G G R G G G G R G G G G G G G R G G G 
G G G R G G G G G G G G R G G G G R R R R R R R R R G G G
G G G R G R R R R R R R R R R G G R G G G G G G G G G G G 
G G G R G R R R R R R R R R R G G R G G G G G G G G G G G 
G G G R R R R . . R R R . . R R R R G G M M M . . . . M G
G G G G G R R . . R R R . . R R R R G G M O F O O O O M G 
G G G G G R R R R R R R R R R G G R G G M O O . . . . M G 
G G G G G R R R R R R R R R R G G R G G G G G G G R G G G
G G G G G G G G R G G G G G G G G R R R R R R R R R G G G
G O G O O G G G R G G G G G F F G R G G G G G G G G G G G
O O O O O G G G R G G G F G G G G R G G G G G G G G G G G
O A Z Z E O G G R G G G G F F G G R G G M M M . . . . M G
G Q S S D G G G R G G G G G G G O R G G M O F O O O O M G
O Q S S C G G F R G G O G G G G O R G G M F O . . . . M G
O Q S D G G R R R G G G O G G G G R G G G G G O O R G G G
G Q S S Z E F G G G G G G G F O G R R R R R R R R R G G G 
O Q S S S D G G G G G G G G F F G G G G G G G G G G G G G
G W X X X C G G G G G G G G G G G G G G G G G G G G G G G 
