S S D R Q S S S S S S S S S S S S S S S S S S S S S S S S
S S D R Q S S S S S S S S S S S S S S S S S S S S S S S S
S S D R Q S S S S S S S S S S S S S S S S S S S S S S S S
S X C R W X S S S S S S S S S S S S S S S S S S S S S S S
C G G R G G W X X X X X X X X X X X X X X X X X X X X X X
G G G R G G G G G G G G G G G G G G G G G G G G G G G G G
G G G R R R R R R R R R R R R R R R R R R G G G G G G G G
G G G R R R R R R R R R R R R R R R R R R G G M M M M M M
G G G G G G G G G G G G G O G G G G G R R G G M O O O O M
M M M M M M M M G G G G G O O G G G G R R G G M O O O O M
O O O O O O O M G G G G G G G G G G G R R G G M O O O O M
O O O O O M M M G G G A Z E G G G G = R R = G M O O O O M
O O O O O M G G G G A S S S E R R R R R R G G M O O O O M
O O O O O M G G G G Q S S S D G G G G R R G O M O O O O M
O O O O O M M M G G W X X X C G G G G R R G G M O O O O M
O O O O O O O M G G O O G G G G G G G R R G G M M M M M M
O O O O O O O M G F G O G G V B G G G R R G G G G G G G G
O O O O O O O M M M M M M M G G G G = R R = G G G G G G G
O O O O O O O O O O O O O M G G G G G R R G G G G G G G G
O O O O O O O F O O O O O M G G G G G R R G G G G G G G G
O O O O O O O O O O O O O M M M G G G R R G M M M M M G G
O O O O O O O O O O O F O O O M G G G R R G M O O O M G G
M M M M M M M M M M M M M M M M G G G R R G M O F O M G G
G G G G G G G G G G G G G G F G G G = R R = M O O O M G G
G G G M M M M M M M M M M M G G G G G R R G M M M M M G G
G G G M O O O O O O O F O M G G G G G R R G G G G G G G G
G G G M O G . . . . . G F M G G O G G R R G G O G G G G G
G G G M G F . . . . . O G M G O O G G R R G G O O O G G G
G G G M F G . . 2 . . G F M G G G G = R R = G O O O G G G
G G G M M M G R R R G F G M G G G O O R R G G G F O G G G
G G G G G G G R R R R R R R R R R R R R R G G M M M M M M
G = = = = G G R R R R R R R R R R R R R R G G M O O O O O
G = = = = G G G G G G G G G G G G G G G G G G G O O O O O
G = = = = G G G G G G G G G G G G G G G G G G M O O O O O 
