G G G G G G G G G G G G G G G G G G G G G G G G G G G G G G G G
G G G G G G G G G G G G G G G G G G G G G G G G G G G G G G G G
G G G G G G G G G G G G G G G G G G G G G G G G G G G G G G G G
G G G G G G G G G G G G G G G G G G G G G G G G G G G G G G G G
G G G G G G G G G G G G G G G G G G G G G G G G G G G G G G G G
G G G G G G V B G G G G G G G G G G G G G G G G G G G G G G G G
G G A Z E G G G G G G G G G G G G G G G G G G G G G G G G G G G
G G Q S D G G G G G G G G G G G G G G G G G G G G G G G G G G G
G G W X C G G G G G G G G G G G G G G G G G G V B G G G G G G G
G G G G G G G G G G G G G G G G G G G G G G G G G G G G G G G G
M M . . . . M M M M M M M M M M M M M M M M M M M M M M M M M M
O G . . . . G O O O O O O O O O O O O O M G G G G G G G A E G G
O G . . . . G O O F O O O O O M M M M M M G G G G G G G W C G G
O G G G G G G O O O O O O M M M G G G G G G G G G G G G G G G G
O O O O O O O O O O O F O M G G G M M . . . M M M M M M M M M M
F F O O O O O O O O O O O M G G G M F . . . . . . G F G F O F M
O F O O O O O O G G O O O M G G G M O . . . . . . F G F G F O M
M M . . . . . M R R M M M M G G G M O . . . . . . O F O F G F M
G G . . 1 . . G R R G V B G G G G M O . . . 2 . . G G G V B G M
G F G G R G G G R R G G G G G G G M M G G R R G G G M M M M M M
G G F G R G G G R R G G G G G G G G G G G R R G G G G G G G G G
G G G R R R R R R R R R R R R R R R R R R R R G G G G G G G G G
G G G R R R R R R R R R R R R R R R R R R R R G G G G G A Z E G
G G G R G G G G G G G G G G G G G G G G G G G G G G G G Q S D G
F G G R G G G G A Z Z Z E G G G G G G G G G G G G G G G W X C G
G G G R A Z Z Z S S S S D G G G G G G G V B G G G G G G G G G G
Z Z E R Q S S S S S S S S Z Z Z Z Z Z Z Z Z Z Z Z Z Z Z Z Z Z E
S S D R Q S S S S S S S S S S S S S S S S S S S S S S S S S S D
