G G G G G G G G G G G G G G G G G G G G G G G G G G G G G G G G
G G G G G G G G G G G G G G G G G G G G G G G G G G G G G G G G
G G G G G G G G G G G G G G G G G G G G G G G G G G G G G G G G
G G G G G G G G G G G G G G G G G G G G G G G G G G G G G G G G
G G G G G G G G G G G G G G G G G G G G G G G G G G G G G G G G
G $ $ $ $ G V B G G G G G G G G G G G G G G G G G G G G G G G G
G % % % % G G G G G G G G G G G G G G G G G G G G G G G G G G G
G G $ $ $ $ $ $ G G $ $ $ G G G G G G G G G G G G G G G G G G G
G G % % % % % % G G % % % G G G G G G G G G G V B G G G G G G G
$ $ $ $ $ $ $ G $ $ $ $ $ $ $ $ G G G G G G G G G G G G G G G G
% % % % % % % $ % % % % % % % % $ M M M M M M M M M M M M M M M
@ | $ | | | | % F O | $ | | | $ % G G G G A Z Z Z Z Z E G G G G
| $ % | @ $ O | G $ @ % O | $ % $ G G G G Q S S S S S D G G G G
O % $ | | % $ O | % $ | O $ % $ % G G G G W X X X X X C G G G G
O @ % $ F | % $ $ $ % @ $ % G % G M M . . . M M M M M M M M M M
$ $ @ % O | | % % % | | % $ | G G M F . . . . . . G F G F O F M
% % V B $ G | $ | @ | $ G % | | G M O . . . . . . F G F G F O M
$ $ $ G % | G % G V B % $ A E G G M O . . . . . . O F O F G F M
% % % $ $ G | | G | | | % W C G G M O . . . 1 . . G G G V B G M
G G G % % G G G G G G G G G G G G M M G G R R G G G M M M M M M
G G G G G R R G G G G G G G G G G G G G G R R G G G G G G G G G
G G G R R R R R R R R R R R R R R R R R R R R G G G G G G G G G
G G G R R R R R R R R R R R R R R R R R R R R G G G G G G G G G
G G G R G G G G G G G G G G G G G G G G G G G G G G G G G G G G
G G G R G G G G A Z Z Z E G G G G G G G G G G G G G G G G G G G
G G G R A Z Z Z S S S S D G G G G G G G G G G G G G G G G G G G
Z Z E R Q S S S S S S S S Z Z Z Z Z Z Z Z Z Z Z Z Z Z Z Z Z Z E
S S D R Q S S S S S S S S S S S S S S S S S S S S S S S S S S D
