l l l l l l l l l l l l l l l 
l n n n n n n n n n n n n n l 
l n n n n n n n n n n n n n l 
l n n n n n n n n n n d t t l 
l n n n n n n n n n m d t t l 
l n n n n n n n n t g n n n l 
l n n n n n n n n t g n d t l 
l n n n n n n n n n n n n n l 
l n n n n n n n n n n n n n l 
l n n n n n n n n n n n n n l 
l n n n n n n n n n n n , ? l
l n n n n n f n f n t n ; ! l 
l t g n n n r n r n n n n n l 
l l l l l l l x l l l l l l l
